R 800 800
NO ./src
SO ./src
WE ./src
EA ./src
S ./src
F 255,255,255
C 255,255,255

111111111111
100000000001
100000000001
100000000001
1000000N0001
100000000001
111111111111