R 1120 720

NO ./textures/redbrick.xpm
SO ./textures/bluestone.xpm
WE ./textures/colorstone.xpm
EA ./textures/wood.xpm

C 0,225,243
F 237,127,16

111111111111111111111111
100000000001100000000001
100110000001100000011001
100011000001100000110001
100001111111111111100001
100000000001100000000001
111111110001100011111111
100000010001100010000001
111110010011110010011111
100000000001100000000001
110011000001100000110011
100001000000000000100001
100001000000000000100001
100001011000E00110100001
100001001000000100100001
111111111110011111111111
100000000100001000000001
100000000000000000000001
100000000100001000000001
111111111110011111111111
100000000010010000000001
100001110000000011100001
100001110010010000000001
111111111111111111111111
