NO ./textures/mur1.xpm
SO ./textures/mur2.xpm
WE ./textures/sol.xpm
EA ./textures/wolf/redbrick.xpm

C 0,225,243
F 224,205,169

1111111111111111111111111
1000000000110000000000001
1011000001110000000000001
1001000000000000000000001
1111111110110000011100001
1000000000111000011101111
1111011111111101110000001
1111011111111101110101001
1100000011111111110000001
1000000000000000110000001
100000000N000000110101001
1100000111010101111101101
1111011111110101110111101
1111111111111111111111111
