NO ./textures/mur1.xpm
SO ./textures/mur2.xpm
WE ./textures/sol.xpm
EA ./textures/wolf/redbrick.xpm

C 0,225,243
F 224,205,169

11111111
10W00001
10000001
10011001
1001 1001
10011001
10000001
10000001
11111111
