NO ./textures/mur1.xpm
SO ./textures/mur2.xpm
WE ./textures/sol.xpm
EA ./textures/wolf/redbrick.xpm

C      0       ,   225              ,               245            
F 224,205,165


 11111111
10W00001
10000001 
10011001   1
10011001  101
10011001   1
10000001
10000001
11111111
    
 
 
11111111  


