R 720 480

NO ./textures/mur1.xpm
SO ./textures/mur2.xpm
WE ./textures/sol.xpm
EA ./textures/wolf/redbrick.xpm

C 0,225,243
F 224,205,169

111111
10S001
100001
100001
111111
