NO ./textures/mur1.xpm
SO ./textures/mur2.xpm
WE ./textures/sol.xpm
EA ./textures/wolf/redbrick.xpm

C 0,225,243
F 224,205,169

    111111
    100001
    10W001
    100001
    100001
    100001
    100001
    100001
    100001          111
11111100111111      101
10000000000001      111
10111000011101
11111111111111
11111111111111
10000000000001
11111100111111
    100001
    100001
    100001
    100001
    100001
    100001
    100001
    111111


